###############################################################
#.............................................................#
#.............................................................#
#...................................................g.........#
#.............................................................#
#.............................................................#
#................@..................S.........................#
#.............................................................#
#.............................................................#
#.............................................................#
#...................................................D.........#
#.............................................................#
#..........................B..................................#
###############################################################
